{
  "problems": [
    {
      "id": 1,
      "title": "Map 1",
      "hidden": false,
      "rows": 6,
      "cols": 5,
      "start": { "x": 1, "y": 1 },
      "goal": { "x": 5, "y": 6 },
      "maxSteps": 9,
      "maxScore": 16,
      "coins": [
        [0, 2, 0, 2, 0],
        [2, 0, 2, 1, 3],
        [0, 3, 2, 1, 0],
        [2, 0, 1, 0, 2],
        [0, 2, 0, 2, 0],
        [0, 3, 2, 0, 2]
      ]
    },
    {
      "id": 2,
      "title": "Map 2",
      "hidden": false,
      "rows": 9,
      "cols": 10,
      "start": { "x": 1, "y": 1 },
      "goal": { "x": 10, "y": 9 },
      "maxSteps": 17,
      "maxScore": 25,
      "coins": [
        [3, 0, 3, 0, 2, 0, 0, 0, 0, 0],
        [0, 0, 1, 1, 0, 3, 0, 0, 0, 0],
        [0, 0, 2, 0, 0, 3, 1, 3, 1, 2],
        [3, 0, 1, 0, 0, 3, 0, 0, 0, 0],
        [0, 0, 1, 0, 0, 1, 0, 0, 0, 1],
        [2, 0, 2, 1, 0, 2, 0, 0, 3, 0],
        [1, 0, 1, 3, 0, 1, 1, 0, 0, 3],
        [2, 0, 2, 0, 0, 3, 2, 2, 2, 0],
        [0, 2, 0, 0, 3, 0, 1, 0, 1, 0]
      ]
    },
    {
      "id": 3,
      "title": "Map 3",
      "hidden": false,
      "rows": 10,
      "cols": 12,
      "start": { "x": 1, "y": 1 },
      "goal": { "x": 12, "y": 10 },
      "maxSteps": 20,
      "maxScore": 44,
      "coins": [
        [1, 1, 1, 1, 1, 1, 2, 2, 2, 0, 2, 0],
        [1, 1, 0, 1, 1, 1, 2, 0, 2, 2, 2, 2],
        [1, 1, 1, 1, 1, 1, 2, 2, 2, 2, 2, 2],
        [3, 3, 3, 3, 3, 3, 3, 3, 2, 2, 0, 0],
        [1, 1, 1, 1, 1, 1, 2, 2, 2, 2, 2, 0],
        [1, 0, 1, 1, 1, 1, 2, 2, 2, 2, 2, 0],
        [1, 1, 1, 1, 1, 1, 2, 2, 2, 1, 2, 3],
        [3, 3, 3, 3, 3, 2, 2, 2, 2, 2, 2, 0],
        [1, 1, 1, 1, 0, 1, 2, 0, 2, 2, 0, 2],
        [0, 1, 1, 1, 1, 1, 2, 2, 2, 2, 2, 2]
      ]
    },
    {
      "id": 4,
      "title": "Map 4",
      "hidden": true,
      "rows": 10,
      "cols": 12,
      "start": { "x": 1, "y": 1 },
      "goal": { "x": 12, "y": 10 },
      "maxSteps": 20,
      "maxScore": 44,
      "coins": [
        [1, 1, 1, 1, 1, 1, 2, 2, 2, 0, 2, 0],
        [1, 1, 0, 1, 1, 1, 2, 0, 2, 2, 2, 2],
        [1, 1, 1, 1, 1, 1, 2, 2, 2, 2, 2, 2],
        [3, 3, 3, 3, 3, 3, 3, 3, 2, 2, 0, 0],
        [1, 1, 1, 1, 1, 1, 2, 2, 2, 2, 2, 0],
        [1, 0, 1, 1, 1, 1, 2, 2, 2, 2, 2, 0],
        [1, 1, 1, 1, 1, 1, 2, 2, 2, 1, 2, 3],
        [3, 3, 3, 3, 3, 2, 2, 2, 2, 2, 2, 0],
        [1, 1, 1, 1, 0, 1, 2, 0, 2, 2, 0, 2],
        [0, 1, 1, 1, 1, 1, 2, 2, 2, 2, 2, 2]
      ]
    }
  ]
}
